T;T;N;N;N;N;N;N;N;T
T;T;T;N;N;T;N;N;N;T
T;T;N;N;T;T;T;N;N;T
T;T;N;N;N;T;T;N;N;T
T;T;N;N;N;T;T;N;N;T
T;T;N;N;N;T;T;N;N;T
T;T;N;N;T;T;N;N;N;T
T;T;N;N;T;T;N;N;N;T
T;T;N;N;N;N;T;N;T;T
T;T;N;N;N;N;N;N;T;T